Residue1,Residue2,Spectral Count,CA Distance mod1,CA Distance mod2,CA Distance,Sequence Distance,Domain Association
47,252,331,9.3,9.9,9.6,205,NTD to NTD
47,275,1,45.9,45.2,45.55,228,NTD to NTD
47,293,153,9.1,10.6,9.85,246,NTD to NTD
47,1820,1,225.6,224.5,225.05,1773,NTD to beta-belt
51,79,1,12.5,13,12.75,28,NTD to NTD
51,293,21,5.6,6.1,5.85,242,NTD to NTD
51,304,1,24.2,25.5,24.85,253,NTD to NTD
100,1100,2,83.7,83.9,83.8,1000,NTD to beta-belt
110,115,27,16.6,16.1,16.35,5,NTD to NTD
110,117,18,22.4,22.4,22.4,7,NTD to NTD
114,117,131,9.6,10,9.8,3,NTD to NTD
114,320,6,19,17.8,18.4,206,NTD to NTD
115,320,10,17.2,15.9,16.55,205,NTD to NTD
117,196,8,48,48.6,48.3,79,NTD to NTD
117,320,813,11,9.9,10.45,203,NTD to NTD
117,327,175,20.1,19.6,19.85,210,NTD to NTD
117,533,1,55.3,55.2,55.25,416,NTD to NTD
117,949,206,14,12.9,13.45,832,NTD to NTD
132,304,21,10.6,10.9,10.75,172,NTD to NTD
139,196,30,24.8,23.2,24,57,NTD to NTD
139,304,27,19.7,20.1,19.9,165,NTD to NTD
139,305,605,16.1,16.6,16.35,166,NTD to NTD
768,141,1,84.8,85.3,85.05,627,NTD to NTD
147,304,241,8.2,9.4,8.8,157,NTD to NTD
147,305,3,11.5,12.4,11.95,158,NTD to NTD
147,2888,9,197.2,197.7,197.45,2741,NTD to beta-belt
196,196,12,0,0,0,0,NTD to NTD
196,252,2093,10.5,11.9,11.2,56,NTD to NTD
196,254,201,12.1,12.3,12.2,58,NTD to NTD
196,273,3,44.5,43.6,44.05,77,NTD to NTD
196,293,90,25.2,26.3,25.75,97,NTD to NTD
196,304,20,41.3,41,41.15,108,NTD to NTD
196,305,1,38.6,38.2,38.4,109,NTD to NTD
196,333,7,70.5,70.6,70.55,137,NTD to NTD
196,616,15,96.9,95.4,96.15,420,NTD to NTD
196,763,1,118.8,118.2,118.5,567,NTD to NTD
196,768,1,113.2,112,112.6,572,NTD to NTD
196,1121,1,137,136.7,136.85,925,NTD to beta-belt
196,1579,1,196.9,198.1,197.5,1383,NTD to beta-belt
196,1984,1,220.4,219.8,220.1,1788,NTD to beta-belt
196,2640,7,212.1,198.6,205.35,2444,NTD to insert 4
196,3772,3,48.2,46.6,47.4,3576,NTD to insert 8
196,3946,1,53.9,53.4,53.65,3750,NTD to beta-belt
196,4103,4,97.7,96.5,97.1,3907,NTD to insert 9
196,4132,1,135,133.7,134.35,3936,NTD to insert 9
196,4207,3,177.4,177.1,177.25,4011,NTD to insert 9
252,2403,1,226,228.7,227.35,2151,NTD to insert 4
252,2640,1,214.2,201.4,207.8,2388,NTD to insert 4
254,293,1,14.5,14.8,14.65,39,NTD to NTD
262,275,601,20,18.7,19.35,13,NTD to NTD
273,333,1,43.1,42.3,42.7,60,NTD to NTD
273,350,5,30.6,30.5,30.55,77,NTD to NTD
273,768,3,96,94.5,95.25,495,NTD to NTD
273,1034,4,67.2,67.5,67.35,761,NTD to beta-belt
273,1043,6,51.5,52.1,51.8,770,NTD to beta-belt
273,1188,1,89.5,89.3,89.4,915,NTD to insert 1
273,1311,7,152.3,104.4,128.35,1038,NTD to insert 2
273,2467,1,189.5,190,189.75,2194,NTD to insert 4
273,4207,17,160.8,161.9,161.35,3934,NTD to insert 9
273,4274,1,174.2,175.8,175,4001,NTD to insert 9
273,4541,58,60,60.4,60.2,4268,NTD to insert 9
275,3163,6,141.8,142.1,141.95,2888,NTD to insert 5
275,3166,11,145.7,146.4,146.05,2891,NTD to beta-belt
275,3772,1,47.4,47.6,47.5,3497,NTD to insert 8
293,304,77,28.6,30.3,29.45,11,NTD to NTD
293,305,106,27.9,29.7,28.8,12,NTD to NTD
293,314,1,40.1,39.7,39.9,21,NTD to NTD
293,334,1,64.7,64.5,64.6,41,NTD to NTD
304,314,218,20.4,19.6,20,10,NTD to NTD
304,320,14,31.7,32.6,32.15,16,NTD to NTD
304,333,9,49.6,50.3,49.95,29,NTD to NTD
304,334,21,51.6,51.8,51.7,30,NTD to NTD
304,350,33,37.8,37,37.4,46,NTD to NTD
304,616,1,61.1,59.5,60.3,312,NTD to NTD
304,763,1,81.5,81.1,81.3,459,NTD to NTD
304,1121,12,126.1,125.5,125.8,817,NTD to beta-belt
304,1311,1,176.4,123.2,149.8,1007,NTD to insert 2
304,1556,5,195.7,194.8,195.25,1252,NTD to beta-belt
305,320,1,33.8,34.3,34.05,15,NTD to NTD
305,333,5,51.1,51.5,51.3,28,NTD to NTD
305,4486,1,140.6,139.1,139.85,4181,NTD to insert 9
314,327,1,24.3,25.2,24.75,13,NTD to NTD
314,333,2,30.2,32.1,31.15,19,NTD to NTD
314,768,5,67.9,68.4,68.15,454,NTD to NTD
320,350,163,15.9,14.7,15.3,30,NTD to NTD
320,949,74,13.2,11.3,12.25,629,NTD to NTD
320,3441,1,127.7,127.8,127.75,3121,NTD to beta-belt
327,334,486,10.3,10.6,10.45,7,NTD to NTD
327,350,3,12.8,12.5,12.65,23,NTD to NTD
327,949,105,13.1,13.3,13.2,622,NTD to NTD
333,350,16,15.9,16.3,16.1,17,NTD to NTD
333,763,1,66.7,66.9,66.8,430,NTD to NTD
333,768,19,65,64.3,64.65,435,NTD to NTD
333,1034,1,43.6,42.4,43,701,NTD to beta-belt
334,350,89,17.4,17.3,17.35,16,NTD to NTD
334,930,180,18.6,17.2,17.9,596,NTD to NTD
334,1442,1,137.3,136.8,137.05,1108,NTD to beta-belt
334,3174,1,153.8,154.4,154.1,2840,NTD to beta-belt
350,533,1,50,48.6,49.3,183,NTD to NTD
350,763,2,73.9,72.9,73.4,413,NTD to NTD
350,768,13,70.9,68.9,69.9,418,NTD to NTD
512,533,1,17.7,18,17.85,21,NTD to NTD
512,537,1,15.4,15.1,15.25,25,NTD to NTD
512,539,908,12.2,11.1,11.65,27,NTD to NTD
518,539,1,21.7,21.1,21.4,21,NTD to NTD
533,2825,1,169.9,170.2,170.05,2292,NTD to beta-belt
537,2825,1,173.9,173.3,173.6,2288,NTD to beta-belt
539,3314,1,60.5,62,61.25,2775,NTD to insert 6
612,616,100,6,6.3,6.15,4,NTD to NTD
613,641,1,21.2,20.1,20.65,28,NTD to NTD
616,641,111,23.4,21.8,22.6,25,NTD to NTD
616,768,2,45.8,46,45.9,152,NTD to NTD
616,3673,43,132.8,132.9,132.85,3057,NTD to insert 7
620,3673,23,139.4,140.8,140.1,3053,NTD to insert 7
707,742,2,17.6,15.5,16.55,35,NTD to NTD
707,745,25,20.1,18.3,19.2,38,NTD to NTD
707,763,1,13.8,12.2,13,56,NTD to NTD
707,768,49,15.2,15.7,15.45,61,NTD to NTD
707,2255,11,68.5,67.6,68.05,1548,NTD to insert 4
717,3449,5,117.5,121.5,119.5,2732,NTD to beta-belt
732,763,1,29.4,29.5,29.45,31,NTD to NTD
732,2255,4,75.9,75.4,75.65,1523,NTD to insert 4
745,2575,1,146.8,94.8,120.8,1830,NTD to insert 4
745,3314,1,85.4,86.1,85.75,2569,NTD to insert 6
763,768,379,8.8,8.6,8.7,5,NTD to NTD
763,1324,33,106.4,57.6,82,561,NTD to insert 2
763,4035,2,130.9,131.1,131,3272,NTD to beta-belt
768,1121,22,110.6,108.8,109.7,353,NTD to beta-belt
923,1034,160,11.3,11.9,11.6,111,NTD to beta-belt
923,1043,39,18.7,19.7,19.2,120,NTD to beta-belt
923,1324,4,109,24,66.5,401,NTD to insert 2
923,2578,2,117.2,76.8,97,1655,NTD to insert 4
949,3630,1,71.7,73.1,72.4,2681,NTD to beta-belt
1034,1052,344,8.2,8,8.1,18,beta-belt to beta-belt
1034,1121,116,35,34.7,34.85,87,beta-belt to beta-belt
1052,1121,28,27.5,27.5,27.5,69,beta-belt to beta-belt
1087,1099,1,37.5,37.1,37.3,12,beta-belt to beta-belt
1087,1115,8,8.6,8.7,8.65,28,beta-belt to beta-belt
1087,1119,104,10.7,11.5,11.1,32,beta-belt to beta-belt
1087,1121,1102,15.6,16.1,15.85,34,beta-belt to beta-belt
1119,2385,6,160.8,158.8,159.8,1266,beta-belt to insert 4
1119,3229,1,126.7,126.2,126.45,2110,beta-belt to insert 6
1119,4485,5,129.5,130.2,129.85,3366,beta-belt to insert 9
1121,1188,42,27.7,27.2,27.45,67,beta-belt to insert 1
1121,1286,1,28.1,28.2,28.15,165,beta-belt to beta-belt
1121,1311,33,71,34.7,52.85,190,beta-belt to insert 2
1121,1579,7,96.1,96.8,96.45,458,beta-belt to beta-belt
1121,2385,2,162.7,160.9,161.8,1264,beta-belt to insert 4
1121,4485,6,123.7,124.6,124.15,3364,beta-belt to insert 9
1188,4259,4,187.3,185.4,186.35,3071,insert 1 to insert 9
1286,1295,2,25.1,19.3,22.2,9,beta-belt to insert 2
1286,1311,60,52.6,44.7,48.65,25,beta-belt to insert 2
1291,1311,27,41.5,44.6,43.05,20,insert 2 to insert 2
1291,2284,1,102.9,103,102.95,993,insert 2 to insert 4
1295,1311,15,31.9,31.6,31.75,16,insert 2 to insert 2
1305,1311,566,10.1,10.2,10.15,6,insert 2 to insert 2
1305,1813,1,115.1,140.8,127.95,508,insert 2 to beta-belt
1305,2575,140,28.9,18.5,23.7,1270,insert 2 to insert 4
1311,1324,213,35.7,35.2,35.45,13,insert 2 to insert 2
1311,1813,12,109.4,139.9,124.65,502,insert 2 to beta-belt
1311,2575,555,35,24,29.5,1264,insert 2 to insert 4
1311,2637,18,14.3,62.8,38.55,1326,insert 2 to insert 4
1311,2640,1,21.2,63.5,42.35,1329,insert 2 to insert 4
1311,4207,1,198.4,192.3,195.35,2896,insert 2 to insert 9
1324,2255,86,100,10.2,55.1,931,insert 2 to insert 4
1324,2575,300,69.9,59,64.45,1251,insert 2 to insert 4
1324,3944,1,166.6,92.9,129.75,2620,insert 2 to beta-belt
1324,4207,1,195.4,187.1,191.25,2883,insert 2 to insert 9
1415,1442,159,9.4,8.3,8.85,27,beta-belt to beta-belt
1436,2833,1,188.2,189.4,188.8,1397,beta-belt to beta-belt
1442,1476,379,14.1,12.8,13.45,34,beta-belt to beta-belt
1476,1485,76,18.7,19.1,18.9,9,beta-belt to beta-belt
1485,1498,134,14,12.8,13.4,13,beta-belt to beta-belt
1556,1577,34,7.8,9,8.4,21,beta-belt to beta-belt
1556,1586,14,11.5,12,11.75,30,beta-belt to beta-belt
1571,1579,53,26.1,25.3,25.7,8,beta-belt to beta-belt
1571,1586,23,7.5,7.7,7.6,15,beta-belt to beta-belt
1579,1593,69,43.4,41.3,42.35,14,beta-belt to beta-belt
1593,2575,1,31.8,73.1,52.45,982,beta-belt to insert 4
1696,1724,161,9.7,10.2,9.95,28,beta-belt to beta-belt
1696,4349,39,78.1,79.4,78.75,2653,beta-belt to insert 9
1702,1730,4,10.1,10.2,10.15,28,beta-belt to beta-belt
1730,1813,9,31.3,30.4,30.85,83,beta-belt to beta-belt
1737,1813,3,26.1,25.2,25.65,76,beta-belt to beta-belt
1750,2002,1,86.9,87.1,87,252,beta-belt to beta-belt
1750,2004,3,88.3,88.2,88.25,254,beta-belt to beta-belt
1769,2002,2,78.3,78.5,78.4,233,beta-belt to beta-belt
1769,2004,8,80.4,80.2,80.3,235,beta-belt to beta-belt
1778,2004,3,79.8,79.9,79.85,226,beta-belt to beta-belt
1813,1820,725,14,13.7,13.85,7,beta-belt to beta-belt
1813,1828,1,14.7,14.7,14.7,15,beta-belt to beta-belt
1813,1858,7,25.4,25.6,25.5,45,beta-belt to beta-belt
1813,2387,1,69.9,70.5,70.2,574,beta-belt to insert 4
1813,2697,93,71.8,47.1,59.45,884,beta-belt to insert 4
1813,3772,11,186.2,186.2,186.2,1959,beta-belt to insert 8
1813,3773,9,185.7,186.5,186.1,1960,beta-belt to insert 8
1813,4103,2,163.6,164.1,163.85,2290,beta-belt to insert 9
1813,4207,1,126.8,126.9,126.85,2394,beta-belt to insert 9
1820,1852,1,16.5,16.4,16.45,32,beta-belt to beta-belt
1828,1858,69,12.1,12,12.05,30,beta-belt to beta-belt
1837,1858,1618,8.6,8.8,8.7,21,beta-belt to beta-belt
1930,1947,161,8.8,8.8,8.8,17,beta-belt to beta-belt
1930,1967,4,9.4,10.1,9.75,37,beta-belt to beta-belt
1947,1967,37,7.9,8.6,8.25,20,beta-belt to beta-belt
1947,1982,32,11.2,12,11.6,35,beta-belt to beta-belt
1947,1984,4,9.3,10.1,9.7,37,beta-belt to beta-belt
1958,2048,1,19.6,19.1,19.35,90,beta-belt to insert 3
1958,4207,28,79.6,79.5,79.55,2249,beta-belt to insert 9
1967,1984,45,8.9,9.1,9,17,beta-belt to beta-belt
2048,2800,17,21,19.3,20.15,752,insert 3 to beta-belt
2100,2117,21,26.7,27.2,26.95,17,insert 4 to insert 4
2100,2139,1,58.9,59.6,59.25,39,insert 4 to insert 4
2100,2270,7,152.8,152.2,152.5,170,insert 4 to insert 4
2100,2387,52,11.3,12,11.65,287,insert 4 to insert 4
2100,2402,64,16.9,18.2,17.55,302,insert 4 to insert 4
2100,2640,9,111.3,130.2,120.75,540,insert 4 to insert 4
2100,2697,27,68.5,82.9,75.7,597,insert 4 to insert 4
2117,2141,96,35.1,35.1,35.1,24,insert 4 to insert 4
2117,2371,339,9.5,9.3,9.4,254,insert 4 to insert 4
2117,2385,17,24.3,25.3,24.8,268,insert 4 to insert 4
2117,2387,1,25,25.9,25.45,270,insert 4 to insert 4
2117,2697,15,48.1,72.8,60.45,580,insert 4 to insert 4
2117,4207,3,160,160.8,160.4,2090,insert 4 to insert 9
2139,2147,4,12.2,12,12.1,8,insert 4 to insert 4
2141,2270,2,107.9,105.7,106.8,129,insert 4 to insert 4
2141,2371,3,37.2,36.8,37,230,insert 4 to insert 4
2141,2697,16,49.4,78.8,64.1,556,insert 4 to insert 4
2210,2270,6,21.7,21.4,21.55,60,insert 4 to insert 4
2210,3148,1,185.9,187.4,186.65,938,insert 4 to insert 5
2224,2270,70,10.5,11.1,10.8,46,insert 4 to insert 4
2224,3210,1,84.6,85,84.8,986,insert 4 to insert 6
2265,3449,1,134.6,136.2,135.4,1184,insert 4 to beta-belt
2270,2284,7,20.7,20.4,20.55,14,insert 4 to insert 4
2270,2286,3,25.6,25.1,25.35,16,insert 4 to insert 4
2270,2340,3,103.6,102,102.8,70,insert 4 to insert 4
2270,3210,8,91.6,93.6,92.6,940,insert 4 to insert 6
2270,3221,16,75.3,76,75.65,951,insert 4 to insert 6
2270,3227,20,71.1,71.5,71.3,957,insert 4 to insert 6
2270,3232,6,67.6,68.6,68.1,962,insert 4 to insert 6
2270,3234,1,65.4,66.5,65.95,964,insert 4 to insert 6
2270,3237,44,72.2,71,71.6,967,insert 4 to insert 6
2270,3314,27,95.6,97,96.3,1044,insert 4 to insert 6
2333,2340,4,10.4,11.3,10.85,7,insert 4 to insert 4
2340,2371,53,47.2,47,47.1,31,insert 4 to insert 4
2340,4485,2,186.7,188.8,187.75,2145,insert 4 to insert 9
2369,2369,2,0,0,0,0,insert 4 to insert 4
2369,2376,307,11.4,10.5,10.95,7,insert 4 to insert 4
2371,2385,4,24.3,24.6,24.45,14,insert 4 to insert 4
2371,2387,4,26.8,27,26.9,16,insert 4 to insert 4
2371,2402,8,46.4,47.6,47,31,insert 4 to insert 4
2376,2637,2,93.3,103,98.15,261,insert 4 to insert 4
2376,3634,1,191.3,189.3,190.3,1258,insert 4 to beta-belt
2402,2410,63,17.3,16.9,17.1,8,insert 4 to insert 4
2403,2425,20,26.5,27.4,26.95,22,insert 4 to insert 4
2403,2637,2,124.1,134.9,129.5,234,insert 4 to insert 4
2410,2634,1,136.5,143.4,139.95,224,insert 4 to insert 4
2410,2637,2,133.7,142.6,138.15,227,insert 4 to insert 4
2425,2428,105,5.3,5.1,5.2,3,insert 4 to insert 4
2575,2578,399,5.1,5.2,5.15,3,insert 4 to insert 4
2575,2634,1,28.1,30.5,29.3,59,insert 4 to insert 4
2575,2637,1,34.9,39.2,37.05,62,insert 4 to insert 4
2575,3634,1,180.1,150.9,165.5,1059,insert 4 to beta-belt
2634,2640,27,13.4,12.3,12.85,6,insert 4 to insert 4
2637,2697,1,52,66.1,59.05,60,insert 4 to insert 4
2640,2697,145,45.4,66,55.7,57,insert 4 to insert 4
2697,4259,3,146.6,125.6,136.1,1562,insert 4 to insert 9
2825,2833,2,26.6,26.2,26.4,8,beta-belt to beta-belt
2825,2853,119,9.3,9.8,9.55,28,beta-belt to beta-belt
2829,2892,1,24.5,24,24.25,63,beta-belt to beta-belt
2864,2892,174,8.4,8.5,8.45,28,beta-belt to beta-belt
2864,2897,48,10.1,11.2,10.65,33,beta-belt to beta-belt
2888,2926,35,10.3,10.4,10.35,38,beta-belt to beta-belt
2892,2930,352,10,9.9,9.95,38,beta-belt to beta-belt
2892,3772,3,160,159.5,159.75,880,beta-belt to insert 8
2930,2966,163,10,10.9,10.45,36,beta-belt to beta-belt
3148,3159,25,17.6,19.4,18.5,11,insert 5 to insert 5
3148,3163,2,22.9,24.7,23.8,15,insert 5 to insert 5
3148,4207,553,26,25.4,25.7,1059,insert 5 to insert 9
3155,3163,61,13.4,13.7,13.55,8,insert 5 to insert 5
3155,4207,189,32.9,34.3,33.6,1052,insert 5 to insert 9
3159,3166,29,8.5,9,8.75,7,insert 5 to beta-belt
3159,4207,23,37.5,38.6,38.05,1048,insert 5 to insert 9
3210,3221,73,17.7,17.9,17.8,11,insert 6 to insert 6
3210,3227,3,25.8,26,25.9,17,insert 6 to insert 6
3210,3237,92,34.3,33.6,33.95,27,insert 6 to insert 6
3210,3314,44,9.3,9.6,9.45,104,insert 6 to insert 6
3221,3232,60,16.6,17,16.8,11,insert 6 to insert 6
3221,3237,100,22.7,21,21.85,16,insert 6 to insert 6
3221,3314,61,21.4,22.2,21.8,93,insert 6 to insert 6
3227,3232,3,6.8,6.7,6.75,5,insert 6 to insert 6
3227,3237,42,14.3,11.2,12.75,10,insert 6 to insert 6
3227,3314,8,26.6,27.2,26.9,87,insert 6 to insert 6
3229,3234,1,7.7,5.9,6.8,5,insert 6 to insert 6
3229,3237,4,12.9,10,11.45,8,insert 6 to insert 6
3232,3237,440,12.4,10.2,11.3,5,insert 6 to insert 6
3237,3314,67,31.8,31.8,31.8,77,insert 6 to insert 6
3441,3451,64,26.6,26.7,26.65,10,beta-belt to beta-belt
3441,3461,22,8.7,8.3,8.5,20,beta-belt to beta-belt
3441,3474,8,16.8,16.4,16.6,33,beta-belt to beta-belt
3451,3501,38,41.2,41,41.1,50,beta-belt to beta-belt
3474,3501,349,5.3,5.7,5.5,27,beta-belt to beta-belt
3497,3531,143,11.9,12.3,12.1,34,beta-belt to beta-belt
3501,3531,53,22,22.4,22.2,30,beta-belt to beta-belt
3501,3537,384,10.2,10.3,10.25,36,beta-belt to beta-belt
3501,4461,3,94.9,93.8,94.35,960,beta-belt to insert 9
3524,3531,32,23.9,23.3,23.6,7,beta-belt to beta-belt
3531,3547,25,7.1,6.9,7,16,beta-belt to beta-belt
3531,3634,4,29.7,28.7,29.2,103,beta-belt to beta-belt
3673,4485,1,44.9,43.4,44.15,812,insert 7 to insert 9
3682,4103,29,13,11.9,12.45,421,insert 7 to insert 9
3729,3772,34,4.6,5.1,4.85,43,insert 8 to insert 8
3772,3946,5,60.3,59.6,59.95,174,insert 8 to beta-belt
3772,3979,1,75.3,74.2,74.75,207,insert 8 to beta-belt
3944,3963,54,8.3,8.5,8.4,19,beta-belt to beta-belt
3944,3973,16,9.8,10.3,10.05,29,beta-belt to beta-belt
3946,3973,1,11.9,12,11.95,27,beta-belt to beta-belt
3946,3979,433,16,15.6,15.8,33,beta-belt to beta-belt
3946,4034,1,31.8,32.6,32.2,88,beta-belt to beta-belt
3946,4035,29,30.8,31.1,30.95,89,beta-belt to beta-belt
4021,4035,2,15.6,15.7,15.65,14,beta-belt to beta-belt
4034,4040,7,15.3,15.5,15.4,6,beta-belt to beta-belt
4034,4071,1,21.3,18.6,19.95,37,beta-belt to insert 9
4035,4103,4,51.2,49.9,50.55,68,beta-belt to insert 9
4071,4518,35,4.9,5.7,5.3,447,insert 9 to insert 9
4076,4103,6,27.8,27.6,27.7,27,insert 9 to insert 9
4076,4518,530,12.3,12.3,12.3,442,insert 9 to insert 9
4103,4132,14,44.1,44.3,44.2,29,insert 9 to insert 9
4103,4207,1,130.4,132.2,131.3,104,insert 9 to insert 9
4103,4274,1,139.5,141,140.25,171,insert 9 to insert 9
4132,4132,1,0,0,0,0,insert 9 to insert 9
4132,4147,218,24.1,23.6,23.85,15,insert 9 to insert 9
4132,4168,1,49.7,48.4,49.05,36,insert 9 to insert 9
4132,4207,11,101.3,102.9,102.1,75,insert 9 to insert 9
4132,4478,12,13.3,12.6,12.95,346,insert 9 to insert 9
4132,4485,62,20.7,20.2,20.45,353,insert 9 to insert 9
4132,4486,16,23.9,23.4,23.65,354,insert 9 to insert 9
4207,4261,32,51.4,52.3,51.85,54,insert 9 to insert 9
4207,4274,64,32.1,32.3,32.2,67,insert 9 to insert 9
4207,4278,347,27.7,27.7,27.7,71,insert 9 to insert 9
4207,4285,102,19.1,20.3,19.7,78,insert 9 to insert 9
4207,4291,651,21.3,22.7,22,84,insert 9 to insert 9
4207,4461,1,98.2,97.6,97.9,254,insert 9 to insert 9
4207,4485,36,117.9,118.9,118.4,278,insert 9 to insert 9
4207,4498,2,131.3,132.8,132.05,291,insert 9 to insert 9
4261,4274,1,20.2,21.8,21,13,insert 9 to insert 9
4261,4278,4,25.8,27.4,26.6,17,insert 9 to insert 9
4274,4285,41,17.1,17.9,17.5,11,insert 9 to insert 9
4274,4291,91,23.2,22.5,22.85,17,insert 9 to insert 9
4278,4291,149,17,16,16.5,13,insert 9 to insert 9
4278,4485,20,117.6,117.8,117.7,207,insert 9 to insert 9
4278,4518,5,156.6,156.6,156.6,240,insert 9 to insert 9
4291,4485,44,105.7,106,105.85,194,insert 9 to insert 9
4461,4465,34,6.5,7.2,6.85,4,insert 9 to insert 9
4478,4486,182,12.9,12.6,12.75,8,insert 9 to insert 9
4485,4498,1,20.7,20.8,20.75,13,insert 9 to insert 9
4485,4518,34,51.1,50.1,50.6,33,insert 9 to insert 9
4486,4498,93,19.2,19.1,19.15,12,insert 9 to insert 9
4486,4518,2,49.3,48,48.65,32,insert 9 to insert 9