Residue1,Residue2,Spectral Count,CA Distance mod1,CA Distance mod2,CA Distance,Sequence Distance,Domain Association
47,252,426,9.3,9.9,9.6,205,NTD to NTD
47,293,352,9.1,10.6,9.85,246,NTD to NTD
47,254,2,6.9,6.6,6.75,207,NTD to NTD
51,293,10,5.6,6.1,5.85,242,NTD to NTD
51,79,8,12.5,13,12.75,28,NTD to NTD
100,1100,2,83.7,83.9,83.8,1000,NTD to beta-belt
110,115,17,16.6,16.1,16.35,5,NTD to NTD
110,117,10,22.4,22.4,22.4,7,NTD to NTD
110,252,1,39.2,37.3,38.25,142,NTD to NTD
114,117,74,9.6,10,9.8,3,NTD to NTD
114,320,1,19,17.8,18.4,206,NTD to NTD
115,320,26,17.2,15.9,16.55,205,NTD to NTD
115,949,4,15.4,14,14.7,834,NTD to NTD
115,1958,1,222.8,223.8,223.3,1843,NTD to beta-belt
115,3174,1,156,158.5,157.25,3059,NTD to beta-belt
117,320,811,11,9.9,10.45,203,NTD to NTD
117,949,271,14,12.9,13.45,832,NTD to NTD
117,327,48,20.1,19.6,19.85,210,NTD to NTD
117,196,3,48,48.6,48.3,79,NTD to NTD
117,923,2,60.6,59.1,59.85,806,NTD to NTD
117,3394,1,128.9,129.9,129.4,3277,NTD to beta-belt
117,2575,1,178.4,129.7,154.05,2458,NTD to insert 4
132,304,26,10.6,10.9,10.75,172,NTD to NTD
139,305,585,16.1,16.6,16.35,166,NTD to NTD
139,196,37,24.8,23.2,24,57,NTD to NTD
139,304,11,19.7,20.1,19.9,165,NTD to NTD
139,157,1,17,17.5,17.25,18,NTD to NTD
147,304,243,8.2,9.4,8.8,157,NTD to NTD
147,2888,4,197.2,197.7,197.45,2741,NTD to beta-belt
147,305,1,11.5,12.4,11.95,158,NTD to NTD
196,252,1911,10.5,11.9,11.2,56,NTD to NTD
196,254,242,12.1,12.3,12.2,58,NTD to NTD
196,293,111,25.2,26.3,25.75,97,NTD to NTD
196,304,47,41.3,41,41.15,108,NTD to NTD
196,2640,31,212.1,198.6,205.35,2444,NTD to insert 4
196,4207,12,177.4,177.1,177.25,4011,NTD to insert 9
196,333,11,70.5,70.6,70.55,137,NTD to NTD
196,196,10,0,0,0,0,NTD to NTD
196,616,8,96.9,95.4,96.15,420,NTD to NTD
196,1121,5,137,136.7,136.85,925,NTD to beta-belt
196,2270,5,112,111.5,111.75,2074,NTD to insert 4
196,1286,3,160.7,160.1,160.4,1090,NTD to beta-belt
196,4132,3,135,133.7,134.35,3936,NTD to insert 9
196,3946,2,53.9,53.4,53.65,3750,NTD to beta-belt
196,3237,1,109.4,105.2,107.3,3041,NTD to insert 6
196,4518,1,92.7,93.3,93,4322,NTD to insert 9
196,763,1,118.8,118.2,118.5,567,NTD to NTD
196,768,1,113.2,112,112.6,572,NTD to NTD
216,314,18,17.4,17.2,17.3,98,NTD to NTD
216,3729,17,26.2,26,26.1,3513,NTD to insert 8
262,275,595,20,18.7,19.35,13,NTD to NTD
273,4541,40,60,60.4,60.2,4268,NTD to insert 9
273,4207,5,160.8,161.9,161.35,3934,NTD to insert 9
273,1034,3,67.2,67.5,67.35,761,NTD to beta-belt
273,350,1,30.6,30.5,30.55,77,NTD to NTD
275,3163,9,141.8,142.1,141.95,2888,NTD to insert 5
275,3166,6,145.7,146.4,146.05,2891,NTD to beta-belt
275,4541,6,64.3,64.3,64.3,4266,NTD to insert 9
275,3729,3,45,44.8,44.9,3454,NTD to insert 8
275,1820,1,189.3,189.3,189.3,1545,NTD to beta-belt
275,2371,1,194.1,193.1,193.6,2096,NTD to insert 4
275,4207,1,164.2,165.6,164.9,3932,NTD to insert 9
293,304,108,28.6,30.3,29.45,11,NTD to NTD
293,305,79,27.9,29.7,28.8,12,NTD to NTD
293,1121,16,138.2,137.7,137.95,828,NTD to beta-belt
293,334,2,64.7,64.5,64.6,41,NTD to NTD
304,314,259,20.4,19.6,20,10,NTD to NTD
304,350,62,37.8,37,37.4,46,NTD to NTD
304,320,31,31.7,32.6,32.15,16,NTD to NTD
304,1121,14,126.1,125.5,125.8,817,NTD to beta-belt
304,334,14,51.6,51.8,51.7,30,NTD to NTD
304,1556,5,195.7,194.8,195.25,1252,NTD to beta-belt
304,763,4,81.5,81.1,81.3,459,NTD to NTD
304,333,3,49.6,50.3,49.95,29,NTD to NTD
304,768,2,74.8,74,74.4,464,NTD to NTD
305,4486,2,140.6,139.1,139.85,4181,NTD to insert 9
305,1311,1,177.3,124.3,150.8,1006,NTD to insert 2
314,333,5,30.2,32.1,31.15,19,NTD to NTD
314,2371,1,188.7,186.9,187.8,2057,NTD to insert 4
314,350,1,17.9,17.7,17.8,36,NTD to NTD
320,350,98,15.9,14.7,15.3,30,NTD to NTD
320,949,67,13.2,11.3,12.25,629,NTD to NTD
320,333,2,21.2,21.5,21.35,13,NTD to NTD
327,334,517,10.3,10.6,10.45,7,NTD to NTD
327,949,66,13.1,13.3,13.2,622,NTD to NTD
327,350,1,12.8,12.5,12.65,23,NTD to NTD
333,350,54,15.9,16.3,16.1,17,NTD to NTD
333,768,10,65,64.3,64.65,435,NTD to NTD
333,3174,1,150.7,151.8,151.25,2841,NTD to beta-belt
333,2117,1,172.2,170.4,171.3,1784,NTD to insert 4
333,2340,1,144.2,142.8,143.5,2007,NTD to insert 4
333,2402,1,188.2,188.7,188.45,2069,NTD to insert 4
334,930,108,18.6,17.2,17.9,596,NTD to NTD
334,350,96,17.4,17.3,17.35,16,NTD to NTD
334,4349,4,170,170.3,170.15,4015,NTD to insert 9
334,3772,3,70.9,71.2,71.05,3438,NTD to insert 8
334,1442,2,137.3,136.8,137.05,1108,NTD to beta-belt
334,3630,1,81.8,81.7,81.75,3296,NTD to beta-belt
350,768,16,70.9,68.9,69.9,418,NTD to NTD
350,2371,2,183.1,180.4,181.75,2021,NTD to insert 4
350,1188,1,92.6,92.2,92.4,838,NTD to insert 1
512,539,750,12.2,11.1,11.65,27,NTD to NTD
512,533,1,17.7,18,17.85,21,NTD to NTD
537,3944,4,98.2,98.2,98.2,3407,NTD to beta-belt
612,616,70,6,6.3,6.15,4,NTD to NTD
613,641,5,21.2,20.1,20.65,28,NTD to NTD
613,4207,1,160.7,162.3,161.5,3594,NTD to insert 9
616,641,119,23.4,21.8,22.6,25,NTD to NTD
616,3673,23,132.8,132.9,132.85,3057,NTD to insert 7
616,768,3,45.8,46,45.9,152,NTD to NTD
620,3673,9,139.4,140.8,140.1,3053,NTD to insert 7
620,641,2,29.5,28.9,29.2,21,NTD to NTD
707,768,56,15.2,15.7,15.45,61,NTD to NTD
707,745,14,20.1,18.3,19.2,38,NTD to NTD
707,2255,5,68.5,67.6,68.05,1548,NTD to insert 4
717,3451,9,114.4,117.8,116.1,2734,NTD to beta-belt
717,3449,7,117.5,121.5,119.5,2732,NTD to beta-belt
717,2833,1,167,168,167.5,2116,NTD to beta-belt
717,3441,1,133.9,136.8,135.35,2724,NTD to beta-belt
745,763,3,24.4,24.5,24.45,18,NTD to NTD
763,768,370,8.8,8.6,8.7,5,NTD to NTD
763,1324,32,106.4,57.6,82,561,NTD to insert 2
768,1121,28,110.6,108.8,109.7,353,NTD to beta-belt
768,3946,1,120.7,119.6,120.15,3178,NTD to beta-belt
768,1324,1,115.1,60.9,88,556,NTD to insert 2
918,923,3,8.6,8,8.3,5,NTD to NTD
921,2575,3,115.1,67.9,91.5,1654,NTD to insert 4
923,1034,195,11.3,11.9,11.6,111,NTD to beta-belt
923,1043,62,18.7,19.7,19.2,120,NTD to beta-belt
1034,1052,318,8.2,8,8.1,18,beta-belt to beta-belt
1034,1121,113,35,34.7,34.85,87,beta-belt to beta-belt
1034,1813,7,165,164.8,164.9,779,beta-belt to beta-belt
1052,1121,28,27.5,27.5,27.5,69,beta-belt to beta-belt
1087,1121,1306,15.6,16.1,15.85,34,beta-belt to beta-belt
1087,1119,156,10.7,11.5,11.1,32,beta-belt to beta-belt
1119,2385,6,160.8,158.8,159.8,1266,beta-belt to insert 4
1121,1188,44,27.7,27.2,27.45,67,beta-belt to insert 1
1121,1579,18,96.1,96.8,96.45,458,beta-belt to beta-belt
1121,1593,16,95.4,94.6,95,472,beta-belt to beta-belt
1121,1311,10,71,34.7,52.85,190,beta-belt to insert 2
1121,4485,9,123.7,124.6,124.15,3364,beta-belt to insert 9
1121,1286,3,28.1,28.2,28.15,165,beta-belt to beta-belt
1121,2385,1,162.7,160.9,161.8,1264,beta-belt to insert 4
1188,4259,4,187.3,185.4,186.35,3071,insert 1 to insert 9
1286,1311,53,52.6,44.7,48.65,25,beta-belt to insert 2
1286,1295,1,25.1,19.3,22.2,9,beta-belt to insert 2
1291,1311,40,41.5,44.6,43.05,20,insert 2 to insert 2
1295,1311,52,31.9,31.6,31.75,16,insert 2 to insert 2
1305,1311,417,10.1,10.2,10.15,6,insert 2 to insert 2
1305,2575,119,28.9,18.5,23.7,1270,insert 2 to insert 4
1305,3944,3,157.6,120.5,139.05,2639,insert 2 to beta-belt
1305,1813,1,115.1,140.8,127.95,508,insert 2 to beta-belt
1311,2575,620,35,24,29.5,1264,insert 2 to insert 4
1311,1324,329,35.7,35.2,35.45,13,insert 2 to insert 2
1311,2640,28,21.2,63.5,42.35,1329,insert 2 to insert 4
1311,2637,22,14.3,62.8,38.55,1326,insert 2 to insert 4
1311,1813,14,109.4,139.9,124.65,502,insert 2 to beta-belt
1311,4207,2,198.4,192.3,195.35,2896,insert 2 to insert 9
1324,2575,287,69.9,59,64.45,1251,insert 2 to insert 4
1324,2255,58,100,10.2,55.1,931,insert 2 to insert 4
1324,2640,4,36.2,97.9,67.05,1316,insert 2 to insert 4
1324,2284,1,86.1,41.4,63.75,960,insert 2 to insert 4
1324,4207,1,195.4,187.1,191.25,2883,insert 2 to insert 9
1415,1442,119,9.4,8.3,8.85,27,beta-belt to beta-belt
1436,1820,6,122.6,123,122.8,384,beta-belt to beta-belt
1436,2833,1,188.2,189.4,188.8,1397,beta-belt to beta-belt
1442,1476,226,14.1,12.8,13.45,34,beta-belt to beta-belt
1476,1485,116,18.7,19.1,18.9,9,beta-belt to beta-belt
1485,1498,77,14,12.8,13.4,13,beta-belt to beta-belt
1556,1577,34,7.8,9,8.4,21,beta-belt to beta-belt
1571,1579,109,26.1,25.3,25.7,8,beta-belt to beta-belt
1571,1586,61,7.5,7.7,7.6,15,beta-belt to beta-belt
1577,1586,2,14.8,14.6,14.7,9,beta-belt to beta-belt
1577,1593,1,38.2,36.1,37.15,16,beta-belt to beta-belt
1579,1593,114,43.4,41.3,42.35,14,beta-belt to beta-belt
1586,2578,1,45.2,81.3,63.25,992,beta-belt to insert 4
1593,2575,1,31.8,73.1,52.45,982,beta-belt to insert 4
1696,1724,102,9.7,10.2,9.95,28,beta-belt to beta-belt
1696,4349,18,78.1,79.4,78.75,2653,beta-belt to insert 9
1730,1813,2,31.3,30.4,30.85,83,beta-belt to beta-belt
1737,1813,2,26.1,25.2,25.65,76,beta-belt to beta-belt
1813,1820,508,14,13.7,13.85,7,beta-belt to beta-belt
1813,2697,93,71.8,47.1,59.45,884,beta-belt to insert 4
1813,1828,5,14.7,14.7,14.7,15,beta-belt to beta-belt
1813,2640,5,100,109.8,104.9,827,beta-belt to insert 4
1813,3773,4,185.7,186.5,186.1,1960,beta-belt to insert 8
1813,3772,2,186.2,186.2,186.2,1959,beta-belt to insert 8
1813,2100,1,75.6,78.1,76.85,287,beta-belt to insert 4
1813,2117,1,80.4,83.8,82.1,304,beta-belt to insert 4
1813,4103,1,163.6,164.1,163.85,2290,beta-belt to insert 9
1813,4207,1,126.8,126.9,126.85,2394,beta-belt to insert 9
1828,1858,116,12.1,12,12.05,30,beta-belt to beta-belt
1837,1858,1428,8.6,8.8,8.7,21,beta-belt to beta-belt
1930,1947,95,8.8,8.8,8.8,17,beta-belt to beta-belt
1947,1982,49,11.2,12,11.6,35,beta-belt to beta-belt
1947,1967,2,7.9,8.6,8.25,20,beta-belt to beta-belt
1947,1984,1,9.3,10.1,9.7,37,beta-belt to beta-belt
1958,4207,100,79.6,79.5,79.55,2249,beta-belt to insert 9
1967,1984,18,8.9,9.1,9,17,beta-belt to beta-belt
1984,2004,1,27.6,26.4,27,20,beta-belt to beta-belt
2048,2800,1,21,19.3,20.15,752,insert 3 to beta-belt
2100,2402,76,16.9,18.2,17.55,302,insert 4 to insert 4
2100,2387,55,11.3,12,11.65,287,insert 4 to insert 4
2100,2117,25,26.7,27.2,26.95,17,insert 4 to insert 4
2100,2697,14,68.5,82.9,75.7,597,insert 4 to insert 4
2100,2640,3,111.3,130.2,120.75,540,insert 4 to insert 4
2100,2270,2,152.8,152.2,152.5,170,insert 4 to insert 4
2117,2371,150,9.5,9.3,9.4,254,insert 4 to insert 4
2117,2141,115,35.1,35.1,35.1,24,insert 4 to insert 4
2117,2385,49,24.3,25.3,24.8,268,insert 4 to insert 4
2117,2697,45,48.1,72.8,60.45,580,insert 4 to insert 4
2117,2403,5,43.1,45.3,44.2,286,insert 4 to insert 4
2117,2387,2,25,25.9,25.45,270,insert 4 to insert 4
2117,2270,1,136.6,134.9,135.75,153,insert 4 to insert 4
2139,2147,3,12.2,12,12.1,8,insert 4 to insert 4
2139,2511,1,34.2,64.4,49.3,372,insert 4 to insert 4
2141,2697,8,49.4,78.8,64.1,556,insert 4 to insert 4
2141,2371,4,37.2,36.8,37,230,insert 4 to insert 4
2141,2270,2,107.9,105.7,106.8,129,insert 4 to insert 4
2141,2640,1,73.9,91.4,82.65,499,insert 4 to insert 4
2210,3148,2,185.9,187.4,186.65,938,insert 4 to insert 5
2224,2270,83,10.5,11.1,10.8,46,insert 4 to insert 4
2270,3314,17,95.6,97,96.3,1044,insert 4 to insert 6
2270,3221,15,75.3,76,75.65,951,insert 4 to insert 6
2270,3227,14,71.1,71.5,71.3,957,insert 4 to insert 6
2270,3237,13,72.2,71,71.6,967,insert 4 to insert 6
2270,3210,11,91.6,93.6,92.6,940,insert 4 to insert 6
2270,3232,6,67.6,68.6,68.1,962,insert 4 to insert 6
2270,2284,3,20.7,20.4,20.55,14,insert 4 to insert 4
2270,2286,2,25.6,25.1,25.35,16,insert 4 to insert 4
2270,2340,1,103.6,102,102.8,70,insert 4 to insert 4
2340,2371,24,47.2,47,47.1,31,insert 4 to insert 4
2369,2376,206,11.4,10.5,10.95,7,insert 4 to insert 4
2371,2402,7,46.4,47.6,47,31,insert 4 to insert 4
2402,2410,43,17.3,16.9,17.1,8,insert 4 to insert 4
2403,2425,4,26.5,27.4,26.95,22,insert 4 to insert 4
2425,2428,1,5.3,5.1,5.2,3,insert 4 to insert 4
2575,2578,146,5.1,5.2,5.15,3,insert 4 to insert 4
2575,2634,2,28.1,30.5,29.3,59,insert 4 to insert 4
2575,2637,2,34.9,39.2,37.05,62,insert 4 to insert 4
2634,2640,71,13.4,12.3,12.85,6,insert 4 to insert 4
2640,2697,94,45.4,66,55.7,57,insert 4 to insert 4
2697,4103,3,187.7,168.3,178,1406,insert 4 to insert 9
2697,4259,1,146.6,125.6,136.1,1562,insert 4 to insert 9
2697,4349,1,142.3,112.7,127.5,1652,insert 4 to insert 9
2825,2853,128,9.3,9.8,9.55,28,beta-belt to beta-belt
2825,2833,5,26.6,26.2,26.4,8,beta-belt to beta-belt
2825,2825,1,0,0,0,0,beta-belt to beta-belt
2829,2892,1,24.5,24,24.25,63,beta-belt to beta-belt
2864,2892,136,8.4,8.5,8.45,28,beta-belt to beta-belt
2864,2897,30,10.1,11.2,10.65,33,beta-belt to beta-belt
2888,2926,36,10.3,10.4,10.35,38,beta-belt to beta-belt
2892,2930,279,10,9.9,9.95,38,beta-belt to beta-belt
2892,3772,1,160,159.5,159.75,880,beta-belt to insert 8
2911,2926,17,13.9,14.1,14,15,beta-belt to beta-belt
2930,2966,140,10,10.9,10.45,36,beta-belt to beta-belt
2966,4207,1,39.4,37.5,38.45,1241,beta-belt to insert 9
3028,4207,9,26.5,27.7,27.1,1179,beta-belt to insert 9
3148,4207,451,26,25.4,25.7,1059,insert 5 to insert 9
3148,3159,40,17.6,19.4,18.5,11,insert 5 to insert 5
3148,3163,2,22.9,24.7,23.8,15,insert 5 to insert 5
3155,4207,185,32.9,34.3,33.6,1052,insert 5 to insert 9
3155,3163,73,13.4,13.7,13.55,8,insert 5 to insert 5
3159,3166,45,8.5,9,8.75,7,insert 5 to beta-belt
3159,4207,13,37.5,38.6,38.05,1048,insert 5 to insert 9
3159,3501,2,49.4,48.9,49.15,342,insert 5 to beta-belt
3210,3237,101,34.3,33.6,33.95,27,insert 6 to insert 6
3210,3221,56,17.7,17.9,17.8,11,insert 6 to insert 6
3210,3314,24,9.3,9.6,9.45,104,insert 6 to insert 6
3210,3227,1,25.8,26,25.9,17,insert 6 to insert 6
3221,3237,125,22.7,21,21.85,16,insert 6 to insert 6
3221,3232,40,16.6,17,16.8,11,insert 6 to insert 6
3221,3314,35,21.4,22.2,21.8,93,insert 6 to insert 6
3221,3234,7,20.7,19.9,20.3,13,insert 6 to insert 6
3221,3229,1,13.5,14.8,14.15,8,insert 6 to insert 6
3227,3237,33,14.3,11.2,12.75,10,insert 6 to insert 6
3227,3314,8,26.6,27.2,26.9,87,insert 6 to insert 6
3227,3234,3,11.2,9.5,10.35,7,insert 6 to insert 6
3227,3232,1,6.8,6.7,6.75,5,insert 6 to insert 6
3229,3237,3,12.9,10,11.45,8,insert 6 to insert 6
3229,3234,1,7.7,5.9,6.8,5,insert 6 to insert 6
3232,3237,470,12.4,10.2,11.3,5,insert 6 to insert 6
3234,3314,4,35.3,34.5,34.9,80,insert 6 to insert 6
3237,3314,114,31.8,31.8,31.8,77,insert 6 to insert 6
3430,3441,7,8.2,8.9,8.55,11,beta-belt to beta-belt
3441,3451,157,26.6,26.7,26.65,10,beta-belt to beta-belt
3441,3461,40,8.7,8.3,8.5,20,beta-belt to beta-belt
3441,3474,1,16.8,16.4,16.6,33,beta-belt to beta-belt
3451,3501,68,41.2,41,41.1,50,beta-belt to beta-belt
3474,3501,301,5.3,5.7,5.5,27,beta-belt to beta-belt
3497,3531,152,11.9,12.3,12.1,34,beta-belt to beta-belt
3501,3537,247,10.2,10.3,10.25,36,beta-belt to beta-belt
3501,3531,44,22,22.4,22.2,30,beta-belt to beta-belt
3501,3524,4,44.7,44,44.35,23,beta-belt to beta-belt
3501,4461,4,94.9,93.8,94.35,960,beta-belt to insert 9
3524,3531,56,23.9,23.3,23.6,7,beta-belt to beta-belt
3531,3547,76,7.1,6.9,7,16,beta-belt to beta-belt
3531,3634,5,29.7,28.7,29.2,103,beta-belt to beta-belt
3634,3673,1,30.7,31.9,31.3,39,beta-belt to insert 7
3673,4207,4,117.6,118.5,118.05,534,insert 7 to insert 9
3673,4485,2,44.9,43.4,44.15,812,insert 7 to insert 9
3682,4103,27,13,11.9,12.45,421,insert 7 to insert 9
3729,3772,7,4.6,5.1,4.85,43,insert 8 to insert 8
3772,3946,4,60.3,59.6,59.95,174,insert 8 to beta-belt
3772,4318,1,146.9,145.1,146,546,insert 8 to insert 9
3944,3963,45,8.3,8.5,8.4,19,beta-belt to beta-belt
3944,3973,26,9.8,10.3,10.05,29,beta-belt to beta-belt
3946,3979,622,16,15.6,15.8,33,beta-belt to beta-belt
3946,4035,53,30.8,31.1,30.95,89,beta-belt to beta-belt
3946,4040,27,33.9,34.2,34.05,94,beta-belt to beta-belt
3946,4034,6,31.8,32.6,32.2,88,beta-belt to beta-belt
3946,3973,3,11.9,12,11.95,27,beta-belt to beta-belt
3946,3963,2,14.7,14.3,14.5,17,beta-belt to beta-belt
4034,4040,18,15.3,15.5,15.4,6,beta-belt to beta-belt
4035,4103,1,51.2,49.9,50.55,68,beta-belt to insert 9
4040,4055,3,7.9,7.6,7.75,15,beta-belt to beta-belt
4071,4518,39,4.9,5.7,5.3,447,insert 9 to insert 9
4076,4518,379,12.3,12.3,12.3,442,insert 9 to insert 9
4076,4103,2,27.8,27.6,27.7,27,insert 9 to insert 9
4087,4103,1,17.3,17.1,17.2,16,insert 9 to insert 9
4103,4132,11,44.1,44.3,44.2,29,insert 9 to insert 9
4103,4207,4,130.4,132.2,131.3,104,insert 9 to insert 9
4103,4147,1,67.6,67.3,67.45,44,insert 9 to insert 9
4103,4498,1,15.5,14.8,15.15,395,insert 9 to insert 9
4132,4147,280,24.1,23.6,23.85,15,insert 9 to insert 9
4132,4485,92,20.7,20.2,20.45,353,insert 9 to insert 9
4132,4486,32,23.9,23.4,23.65,354,insert 9 to insert 9
4132,4207,17,101.3,102.9,102.1,75,insert 9 to insert 9
4132,4274,5,105.4,106.5,105.95,142,insert 9 to insert 9
4132,4478,3,13.3,12.6,12.95,346,insert 9 to insert 9
4207,4291,569,21.3,22.7,22,84,insert 9 to insert 9
4207,4278,324,27.7,27.7,27.7,71,insert 9 to insert 9
4207,4274,82,32.1,32.3,32.2,67,insert 9 to insert 9
4207,4285,43,19.1,20.3,19.7,78,insert 9 to insert 9
4207,4485,30,117.9,118.9,118.4,278,insert 9 to insert 9
4207,4498,2,131.3,132.8,132.05,291,insert 9 to insert 9
4207,4261,1,51.4,52.3,51.85,54,insert 9 to insert 9
4261,4274,4,20.2,21.8,21,13,insert 9 to insert 9
4274,4291,32,23.2,22.5,22.85,17,insert 9 to insert 9
4274,4285,1,17.1,17.9,17.5,11,insert 9 to insert 9
4278,4291,108,17,16,16.5,13,insert 9 to insert 9
4291,4485,4,105.7,106,105.85,194,insert 9 to insert 9
4318,4486,1,77.8,76.5,77.15,168,insert 9 to insert 9
4461,4465,52,6.5,7.2,6.85,4,insert 9 to insert 9
4461,4463,2,5.5,5.7,5.6,2,insert 9 to insert 9
4478,4486,218,12.9,12.6,12.75,8,insert 9 to insert 9
4485,4518,37,51.1,50.1,50.6,33,insert 9 to insert 9
4485,4498,3,20.7,20.8,20.75,13,insert 9 to insert 9
4486,4498,69,19.2,19.1,19.15,12,insert 9 to insert 9
4486,4518,5,49.3,48,48.65,32,insert 9 to insert 9