Residue1,Residue2,Spectral Count,CA Distance mod1,CA Distance mod2,CA Distance,Sequence Distance,Domain Association
47,254,2,6.9,6.6,6.75,207,NTD to NTD
110,252,1,39.2,37.3,38.25,142,NTD to NTD
115,949,4,15.4,14.0,14.7,834,NTD to NTD
115,1958,1,222.8,223.8,223.3,1843,NTD to beta-belt
115,3174,1,156.0,158.5,157.25,3059,NTD to beta-belt
117,923,2,60.6,59.1,59.85,806,NTD to NTD
117,3394,1,128.9,129.9,129.4,3277,NTD to beta-belt
117,2575,1,178.4,129.7,154.05,2458,NTD to insert 4
139,157,1,17.0,17.5,17.25,18,NTD to NTD
196,2270,5,112.0,111.5,111.75,2074,NTD to insert 4
196,1286,3,160.7,160.1,160.4,1090,NTD to beta-belt
196,3237,1,109.4,105.2,107.3,3041,NTD to insert 6
196,4518,1,92.7,93.3,93.0,4322,NTD to insert 9
216,314,18,17.4,17.2,17.3,98,NTD to NTD
216,3729,17,26.2,26.0,26.1,3513,NTD to insert 8
275,4541,6,64.3,64.3,64.3,4266,NTD to insert 9
275,3729,3,45.0,44.8,44.9,3454,NTD to insert 8
275,1820,1,189.3,189.3,189.3,1545,NTD to beta-belt
275,2371,1,194.1,193.1,193.6,2096,NTD to insert 4
275,4207,1,164.2,165.6,164.9,3932,NTD to insert 9
293,1121,16,138.2,137.7,137.95,828,NTD to beta-belt
304,768,2,74.8,74.0,74.4,464,NTD to NTD
305,1311,1,177.3,124.3,150.8,1006,NTD to insert 2
314,2371,1,188.7,186.9,187.8,2057,NTD to insert 4
314,350,1,17.9,17.7,17.8,36,NTD to NTD
320,333,2,21.2,21.5,21.35,13,NTD to NTD
333,3174,1,150.7,151.8,151.25,2841,NTD to beta-belt
333,2117,1,172.2,170.4,171.3,1784,NTD to insert 4
333,2340,1,144.2,142.8,143.5,2007,NTD to insert 4
333,2402,1,188.2,188.7,188.45,2069,NTD to insert 4
334,4349,4,170.0,170.3,170.15,4015,NTD to insert 9
334,3772,3,70.9,71.2,71.05,3438,NTD to insert 8
334,3630,1,81.8,81.7,81.75,3296,NTD to beta-belt
350,2371,2,183.1,180.4,181.75,2021,NTD to insert 4
350,1188,1,92.6,92.2,92.4,838,NTD to insert 1
537,3944,4,98.2,98.2,98.2,3407,NTD to beta-belt
613,4207,1,160.7,162.3,161.5,3594,NTD to insert 9
620,641,2,29.5,28.9,29.2,21,NTD to NTD
717,3451,9,114.4,117.8,116.1,2734,NTD to beta-belt
717,2833,1,167.0,168.0,167.5,2116,NTD to beta-belt
717,3441,1,133.9,136.8,135.35,2724,NTD to beta-belt
745,763,3,24.4,24.5,24.45,18,NTD to NTD
768,3946,1,120.7,119.6,120.15,3178,NTD to beta-belt
768,1324,1,115.1,60.9,88.0,556,NTD to insert 2
918,923,3,8.6,8.0,8.3,5,NTD to NTD
921,2575,3,115.1,67.9,91.5,1654,NTD to insert 4
1034,1813,7,165.0,164.8,164.9,779,beta-belt to beta-belt
1121,1593,16,95.4,94.6,95.0,472,beta-belt to beta-belt
1305,3944,3,157.6,120.5,139.05,2639,insert 2 to beta-belt
1324,2640,4,36.2,97.9,67.05,1316,insert 2 to insert 4
1324,2284,1,86.1,41.4,63.75,960,insert 2 to insert 4
1436,1820,6,122.6,123.0,122.8,384,beta-belt to beta-belt
1577,1586,2,14.8,14.6,14.7,9,beta-belt to beta-belt
1577,1593,1,38.2,36.1,37.15,16,beta-belt to beta-belt
1586,2578,1,45.2,81.3,63.25,992,beta-belt to insert 4
1813,2640,5,100.0,109.8,104.9,827,beta-belt to insert 4
1813,2100,1,75.6,78.1,76.85,287,beta-belt to insert 4
1813,2117,1,80.4,83.8,82.1,304,beta-belt to insert 4
1984,2004,1,27.6,26.4,27.0,20,beta-belt to beta-belt
2117,2403,5,43.1,45.3,44.2,286,insert 4 to insert 4
2117,2270,1,136.6,134.9,135.75,153,insert 4 to insert 4
2139,2511,1,34.2,64.4,49.3,372,insert 4 to insert 4
2141,2640,1,73.9,91.4,82.65,499,insert 4 to insert 4
2697,4103,3,187.7,168.3,178.0,1406,insert 4 to insert 9
2697,4349,1,142.3,112.7,127.5,1652,insert 4 to insert 9
2825,2825,1,0.0,0.0,0.0,0,beta-belt to beta-belt
2911,2926,17,13.9,14.1,14.0,15,beta-belt to beta-belt
2966,4207,1,39.4,37.5,38.45,1241,beta-belt to insert 9
3028,4207,9,26.5,27.7,27.1,1179,beta-belt to insert 9
3159,3501,2,49.4,48.9,49.15,342,insert 5 to beta-belt
3221,3234,7,20.7,19.9,20.3,13,insert 6 to insert 6
3221,3229,1,13.5,14.8,14.15,8,insert 6 to insert 6
3227,3234,3,11.2,9.5,10.35,7,insert 6 to insert 6
3234,3314,4,35.3,34.5,34.9,80,insert 6 to insert 6
3430,3441,7,8.2,8.9,8.55,11,beta-belt to beta-belt
3501,3524,4,44.7,44.0,44.35,23,beta-belt to beta-belt
3634,3673,1,30.7,31.9,31.3,39,beta-belt to insert 7
3673,4207,4,117.6,118.5,118.05,534,insert 7 to insert 9
3772,4318,1,146.9,145.1,146.0,546,insert 8 to insert 9
3946,4040,27,33.9,34.2,34.05,94,beta-belt to beta-belt
3946,3963,2,14.7,14.3,14.5,17,beta-belt to beta-belt
4040,4055,3,7.9,7.6,7.75,15,beta-belt to beta-belt
4087,4103,1,17.3,17.1,17.2,16,insert 9 to insert 9
4103,4147,1,67.6,67.3,67.45,44,insert 9 to insert 9
4103,4498,1,15.5,14.8,15.15,395,insert 9 to insert 9
4132,4274,5,105.4,106.5,105.95,142,insert 9 to insert 9
4318,4486,1,77.8,76.5,77.15,168,insert 9 to insert 9
4461,4463,2,5.5,5.7,5.6,2,insert 9 to insert 9
