Residue1,Residue2,Spectral Count,CA Distance mod1,CA Distance mod2,CA Distance,Sequence Distance,Domain Association
47,275,1,45.9,45.2,45.55,228,NTD to NTD
47,1820,1,225.6,224.5,225.05,1773,NTD to beta-belt
51,304,1,24.2,25.5,24.85,253,NTD to NTD
117,533,1,55.3,55.2,55.25,416,NTD to NTD
768,141,1,84.8,85.3,85.05,627,NTD to NTD
196,273,3,44.5,43.6,44.05,77,NTD to NTD
196,305,1,38.6,38.2,38.4,109,NTD to NTD
196,1579,1,196.9,198.1,197.5,1383,NTD to beta-belt
196,1984,1,220.4,219.8,220.1,1788,NTD to beta-belt
196,3772,3,48.2,46.6,47.4,3576,NTD to insert 8
196,4103,4,97.7,96.5,97.1,3907,NTD to insert 9
252,2403,1,226.0,228.7,227.35,2151,NTD to insert 4
252,2640,1,214.2,201.4,207.8,2388,NTD to insert 4
254,293,1,14.5,14.8,14.65,39,NTD to NTD
273,333,1,43.1,42.3,42.7,60,NTD to NTD
273,768,3,96.0,94.5,95.25,495,NTD to NTD
273,1043,6,51.5,52.1,51.8,770,NTD to beta-belt
273,1188,1,89.5,89.3,89.4,915,NTD to insert 1
273,1311,7,152.3,104.4,128.35,1038,NTD to insert 2
273,2467,1,189.5,190.0,189.75,2194,NTD to insert 4
273,4274,1,174.2,175.8,175.0,4001,NTD to insert 9
275,3772,1,47.4,47.6,47.5,3497,NTD to insert 8
293,314,1,40.1,39.7,39.9,21,NTD to NTD
304,616,1,61.1,59.5,60.3,312,NTD to NTD
304,1311,1,176.4,123.2,149.8,1007,NTD to insert 2
305,320,1,33.8,34.3,34.05,15,NTD to NTD
305,333,5,51.1,51.5,51.3,28,NTD to NTD
314,327,1,24.3,25.2,24.75,13,NTD to NTD
314,768,5,67.9,68.4,68.15,454,NTD to NTD
320,3441,1,127.7,127.8,127.75,3121,NTD to beta-belt
333,763,1,66.7,66.9,66.8,430,NTD to NTD
333,1034,1,43.6,42.4,43.0,701,NTD to beta-belt
334,3174,1,153.8,154.4,154.1,2840,NTD to beta-belt
350,533,1,50.0,48.6,49.3,183,NTD to NTD
350,763,2,73.9,72.9,73.4,413,NTD to NTD
512,537,1,15.4,15.1,15.25,25,NTD to NTD
518,539,1,21.7,21.1,21.4,21,NTD to NTD
533,2825,1,169.9,170.2,170.05,2292,NTD to beta-belt
537,2825,1,173.9,173.3,173.6,2288,NTD to beta-belt
539,3314,1,60.5,62.0,61.25,2775,NTD to insert 6
707,742,2,17.6,15.5,16.55,35,NTD to NTD
707,763,1,13.8,12.2,13.0,56,NTD to NTD
732,763,1,29.4,29.5,29.45,31,NTD to NTD
732,2255,4,75.9,75.4,75.65,1523,NTD to insert 4
745,2575,1,146.8,94.8,120.8,1830,NTD to insert 4
745,3314,1,85.4,86.1,85.75,2569,NTD to insert 6
763,4035,2,130.9,131.1,131.0,3272,NTD to beta-belt
923,1324,4,109.0,24.0,66.5,401,NTD to insert 2
923,2578,2,117.2,76.8,97.0,1655,NTD to insert 4
949,3630,1,71.7,73.1,72.4,2681,NTD to beta-belt
1087,1099,1,37.5,37.1,37.3,12,beta-belt to beta-belt
1087,1115,8,8.6,8.7,8.65,28,beta-belt to beta-belt
1119,3229,1,126.7,126.2,126.45,2110,beta-belt to insert 6
1119,4485,5,129.5,130.2,129.85,3366,beta-belt to insert 9
1291,2284,1,102.9,103.0,102.95,993,insert 2 to insert 4
1324,3944,1,166.6,92.9,129.75,2620,insert 2 to beta-belt
1556,1586,14,11.5,12.0,11.75,30,beta-belt to beta-belt
1702,1730,4,10.1,10.2,10.15,28,beta-belt to beta-belt
1750,2002,1,86.9,87.1,87.0,252,beta-belt to beta-belt
1750,2004,3,88.3,88.2,88.25,254,beta-belt to beta-belt
1769,2002,2,78.3,78.5,78.4,233,beta-belt to beta-belt
1769,2004,8,80.4,80.2,80.3,235,beta-belt to beta-belt
1778,2004,3,79.8,79.9,79.85,226,beta-belt to beta-belt
1813,1858,7,25.4,25.6,25.5,45,beta-belt to beta-belt
1813,2387,1,69.9,70.5,70.2,574,beta-belt to insert 4
1820,1852,1,16.5,16.4,16.45,32,beta-belt to beta-belt
1930,1967,4,9.4,10.1,9.75,37,beta-belt to beta-belt
1958,2048,1,19.6,19.1,19.35,90,beta-belt to insert 3
2100,2139,1,58.9,59.6,59.25,39,insert 4 to insert 4
2117,4207,3,160.0,160.8,160.4,2090,insert 4 to insert 9
2210,2270,6,21.7,21.4,21.55,60,insert 4 to insert 4
2224,3210,1,84.6,85.0,84.8,986,insert 4 to insert 6
2265,3449,1,134.6,136.2,135.4,1184,insert 4 to beta-belt
2270,3234,1,65.4,66.5,65.95,964,insert 4 to insert 6
2333,2340,4,10.4,11.3,10.85,7,insert 4 to insert 4
2340,4485,2,186.7,188.8,187.75,2145,insert 4 to insert 9
2369,2369,2,0.0,0.0,0.0,0,insert 4 to insert 4
2371,2385,4,24.3,24.6,24.45,14,insert 4 to insert 4
2371,2387,4,26.8,27.0,26.9,16,insert 4 to insert 4
2376,2637,2,93.3,103.0,98.15,261,insert 4 to insert 4
2376,3634,1,191.3,189.3,190.3,1258,insert 4 to beta-belt
2403,2637,2,124.1,134.9,129.5,234,insert 4 to insert 4
2410,2634,1,136.5,143.4,139.95,224,insert 4 to insert 4
2410,2637,2,133.7,142.6,138.15,227,insert 4 to insert 4
2575,3634,1,180.1,150.9,165.5,1059,insert 4 to beta-belt
2637,2697,1,52.0,66.1,59.05,60,insert 4 to insert 4
3772,3979,1,75.3,74.2,74.75,207,insert 8 to beta-belt
4021,4035,2,15.6,15.7,15.65,14,beta-belt to beta-belt
4034,4071,1,21.3,18.6,19.95,37,beta-belt to insert 9
4103,4274,1,139.5,141.0,140.25,171,insert 9 to insert 9
4132,4132,1,0.0,0.0,0.0,0,insert 9 to insert 9
4132,4168,1,49.7,48.4,49.05,36,insert 9 to insert 9
4207,4461,1,98.2,97.6,97.9,254,insert 9 to insert 9
4261,4278,4,25.8,27.4,26.6,17,insert 9 to insert 9
4278,4485,20,117.6,117.8,117.7,207,insert 9 to insert 9
4278,4518,5,156.6,156.6,156.6,240,insert 9 to insert 9
